60
       BBBV    V
B H   B      B  
B     P   BBBB  
BH    PPPPP     
B               
B               
BH   BBBB   BBBB
B     B  B  B   
B     B  BBBB   
B     B         
BBBBBBB   P     
