12
       BBB      
B H   B      B  
B     P   BBBB  
B     PPPPP     
B               
B               
B     BBBB  BBBB
B     B  B  B   
B     B  BBBB   
B     B         
BBBBBBB   P     
