12
      B      BBB
B     B      B V
B     PV  BBBB  
BH    PPPPP     
B               
B               
B     BBBB  BBBB
B     B  B  BV  
B     B  BBBB   
BH    B         
BBBBBBB   P     
