12
     VBB     BBB
B H   B      BVV
B     P   BBBB  
BH    PPPPPVVV  
B               
B               
B     BBBB  BBBB
B     B  B VB   
B     B  BBBB   
BV    B         
BBBBBBB   P     
